S000001111000
0111101111010
0000100001010
0111101111010
0000000000010
1111111111010
0000000000010
0111111111110
000000000000G